"a" = (/obj/machinery/gateway{dir = 10},/turf/simulated/floor/trim/darkwood,/area/crew_quarters/captain)
"b" = (/obj/structure/closet/secure_closet/captains,/obj/item/clothing/accessory/holster/thigh,/turf/simulated/floor/trim/darkwood,/area/crew_quarters/captain)
"c" = (/obj/effect/floor_decal/industrial/warning/dust/corner{dir = 8; icon_state = "warningcorner_dust"},/turf/simulated/floor/exoplanet/snow,/area/exoplanet/snow)
"d" = (/obj/structure/cable/yellow{d1 = 1; d2 = 2; icon_state = "1-2"},/turf/simulated/wall/r_wall,/area/crew_quarters/captain)
"e" = (/obj/machinery/gateway{dir = 9},/turf/simulated/floor/trim/darkwood,/area/crew_quarters/captain)
"f" = (/obj/machinery/gateway{dir = 6},/turf/simulated/floor/trim/darkwood,/area/crew_quarters/captain)
"g" = (/turf/simulated/floor/trim/darkwood,/area/crew_quarters/captain)
"h" = (/obj/machinery/power/solar,/turf/simulated/floor/exoplanet/snow,/area/exoplanet/snow)
"i" = (/obj/structure/cable/yellow,/obj/structure/cable/yellow{d2 = 4; icon_state = "0-4"},/obj/structure/cable/yellow{d2 = 8; icon_state = "0-8"},/obj/effect/floor_decal/industrial/warning/dust,/obj/structure/railing,/turf/simulated/floor/exoplanet/snow,/area/exoplanet/snow)
"j" = (/obj/structure/table/woodentable,/turf/simulated/floor/trim/darkwood,/area/crew_quarters/captain)
"k" = (/obj/machinery/gateway,/obj/effect/landmark{name = "JoinLateGateway"},/obj/effect/landmark{name = "JoinLateCryo"},/obj/effect/landmark{name = "JoinLate"},/obj/effect/landmark/start{name = "Captain"},/turf/simulated/floor/trim/darkwood,/area/crew_quarters/captain)
"l" = (/obj/structure/cable/yellow{d1 = 2; d2 = 4; icon_state = "2-4"},/turf/simulated/floor/trim/darkwood,/area/crew_quarters/captain)
"m" = (/obj/machinery/gateway/centerstation,/turf/simulated/floor/trim/darkwood,/area/crew_quarters/captain)
"n" = (/obj/effect/floor_decal/industrial/warning/dust{dir = 4; icon_state = "warning_dust"},/obj/structure/railing{dir = 4},/turf/simulated/floor/exoplanet/snow,/area/exoplanet/snow)
"o" = (/obj/structure/cable/yellow{d2 = 2; icon_state = "0-2"},/obj/machinery/power/terminal{dir = 8},/obj/structure/cable/yellow{d1 = 2; d2 = 4; icon_state = "2-4"},/turf/simulated/floor/trim/darkwood,/area/crew_quarters/captain)
"p" = (/obj/structure/cable/yellow{d1 = 2; d2 = 4; icon_state = "2-4"},/turf/simulated/floor/exoplanet/snow,/area/exoplanet/snow)
"q" = (/turf/simulated/mineral,/area/exoplanet/snow)
"r" = (/obj/machinery/gateway{dir = 4},/turf/simulated/floor/trim/darkwood,/area/crew_quarters/captain)
"s" = (/obj/structure/cable/yellow{d1 = 1; d2 = 2; icon_state = "1-2"},/turf/simulated/floor/exoplanet/snow,/area/exoplanet/snow)
"t" = (/obj/machinery/power/smes/buildable{RCon_tag = "Substation - Command"; charge = 0; input_level = 250000; input_level_max = 250000; output_level = 250000; output_level_max = 250000},/obj/structure/cable/green{d2 = 8; icon_state = "0-8"},/turf/simulated/floor/trim/darkwood,/area/crew_quarters/captain)
"u" = (/obj/effect/floor_decal/industrial/warning/dust,/obj/structure/railing,/turf/simulated/floor/exoplanet/snow,/area/exoplanet/snow)
"w" = (/obj/machinery/gateway{dir = 1},/turf/simulated/floor/trim/darkwood,/area/crew_quarters/captain)
"x" = (/obj/machinery/power/terminal,/obj/structure/cable/yellow{d2 = 8; icon_state = "0-8"},/turf/simulated/floor/trim/darkwood,/area/crew_quarters/captain)
"y" = (/obj/structure/cable/yellow{d1 = 4; d2 = 8; icon_state = "4-8"},/obj/effect/floor_decal/industrial/warning/dust,/obj/structure/railing,/turf/simulated/floor/exoplanet/snow,/area/exoplanet/snow)
"z" = (/obj/structure/cable/yellow{d1 = 4; d2 = 8; icon_state = "4-8"},/turf/simulated/floor/trim/darkwood,/area/crew_quarters/captain)
"B" = (/obj/structure/table/woodentable,/obj/item/weapon/stamp/captain{pixel_x = -4; pixel_y = 3},/obj/item/weapon/stamp/denied{pixel_x = 4; pixel_y = 3},/obj/item/weapon/folder/blue,/obj/item/weapon/paper_bin{pixel_x = -3; pixel_y = 7},/obj/item/weapon/pen,/turf/simulated/floor/trim/darkwood,/area/crew_quarters/captain)
"D" = (/obj/machinery/door/unpowered/simple/wood,/turf/simulated/floor/trim/darkwood,/area/crew_quarters/captain)
"E" = (/turf/simulated/wall/r_wall,/area/crew_quarters/captain)
"F" = (/obj/machinery/gateway{dir = 8},/turf/simulated/floor/trim/darkwood,/area/crew_quarters/captain)
"G" = (/obj/effect/floor_decal/industrial/warning/dust/corner{dir = 4; icon_state = "warningcorner_dust"},/turf/simulated/floor/exoplanet/snow,/area/exoplanet/snow)
"H" = (/obj/effect/floor_decal/industrial/warning/dust/corner{dir = 1; icon_state = "warningcorner_dust"},/turf/simulated/floor/exoplanet/snow,/area/exoplanet/snow)
"I" = (/obj/effect/floor_decal/industrial/warning/dust{dir = 1; icon_state = "warning_dust"},/obj/structure/railing{dir = 1},/turf/simulated/floor/exoplanet/snow,/area/exoplanet/snow)
"J" = (/obj/effect/floor_decal/industrial/warning/dust/corner,/turf/simulated/floor/exoplanet/snow,/area/exoplanet/snow)
"K" = (/obj/item/weapon/storage/toolbox/mechanical,/obj/machinery/power/solar_control/autostart,/obj/structure/cable/yellow{d2 = 8; icon_state = "0-8"},/turf/simulated/floor/trim/darkwood,/area/crew_quarters/captain)
"L" = (/obj/structure/cable/yellow{d1 = 4; d2 = 8; icon_state = "4-8"},/obj/structure/cable/yellow{d1 = 2; d2 = 8; icon_state = "2-8"},/obj/structure/cable/yellow{d1 = 2; d2 = 4; icon_state = "2-4"},/turf/simulated/floor/exoplanet/snow,/area/exoplanet/snow)
"M" = (/obj/structure/cable/yellow{d1 = 2; d2 = 8; icon_state = "2-8"},/turf/simulated/floor/exoplanet/snow,/area/exoplanet/snow)
"N" = (/obj/machinery/power/tracker,/obj/structure/cable/yellow,/turf/simulated/floor/exoplanet/snow,/area/exoplanet/snow)
"O" = (/obj/machinery/power/apc{dir = 2; name = "south bump"; pixel_y = -24},/obj/structure/cable/green{d2 = 4; icon_state = "0-4"},/turf/simulated/floor/trim/darkwood,/area/crew_quarters/captain)
"P" = (/obj/effect/floor_decal/industrial/warning/dust{dir = 8; icon_state = "warning_dust"},/obj/structure/railing{dir = 8},/turf/simulated/floor/exoplanet/snow,/area/exoplanet/snow)
"S" = (/obj/structure/cable/yellow{d2 = 4; icon_state = "0-4"},/obj/machinery/power/smes/buildable{RCon_tag = "Substation - Command"; charge = 0; input_level = 250000; input_level_max = 250000; output_level = 250000; output_level_max = 250000},/obj/structure/cable/yellow,/turf/simulated/floor/trim/darkwood,/area/crew_quarters/captain)
"T" = (/turf/simulated/floor/exoplanet/snow,/area/exoplanet/snow)
"U" = (/obj/structure/barricade,/obj/effect/wingrille_spawn/reinforced,/turf/simulated/floor/plating,/area/crew_quarters/captain)
"V" = (/obj/structure/table/woodentable,/obj/item/modular_computer/console/preset/command,/turf/simulated/floor/trim/darkwood,/area/crew_quarters/captain)
"W" = (/obj/structure/cable/yellow{d1 = 1; d2 = 4; icon_state = "1-4"},/obj/structure/cable/yellow{d1 = 1; d2 = 8; icon_state = "1-8"},/obj/structure/cable/yellow{d1 = 1; d2 = 2; icon_state = "1-2"},/turf/simulated/floor/exoplanet/snow,/area/exoplanet/snow)
"Y" = (/obj/machinery/gateway{dir = 5},/turf/simulated/floor/trim/darkwood,/area/crew_quarters/captain)
"Z" = (/obj/structure/cable/yellow{d1 = 1; d2 = 4; icon_state = "1-4"},/obj/structure/cable/yellow{d1 = 1; d2 = 8; icon_state = "1-8"},/turf/simulated/floor/exoplanet/snow,/area/exoplanet/snow)

(1,1,1) = {"
qqqqqqqqqqqqqqqqqqqqqqqqqqqqqqqqqqqqqqqqqqqqqqqqqqqqqqqqqqqqqqqqqqqqqqqqqqqqqqqqqqqqqqqqqqqqqqqqqqqq
qqqqqqqqqqqqqqqqqqqqqqqqqqqqqqqqqqqqqqqqqqqqqqqqqqqqqqqqqqqqqqqqqqqqqqqqqqqqqqqqqqqqqqqqqqqqqqqqqqqq
qqqqqqqqqqqqqqqqqqqqqqqqqqqqqqqqqqqqqqqqqqqqqqqqqqqqqqqqqqqqqqqqqqqqqqqqqqqqqqqqqqqqqqqqqqqqqqqqqqqq
qqqqqqqqqqqqqqqqqqqqqqqqqqqqqqqqqqqqqqqqqqqqqqqqqqqqqqqqqqqqqqqqqqqqqqqqqqqqqqqqqqqqqqqqqqqqqqqqqqqq
qqqqTTTTTTTTTTTTTTTTTTTTTTTTTTTTTTTTTTTTTTTTTTTTTTTTTTTTTTTTTTTTTTTTTTTTTTTTTTTTTTTTTTTTTTTTTTTTqqqq
qqqqTTTTTTTTTTTTTTTTTTTTTTTTTTTTTTTTTTTTTTTTTTTTTTTTTTTTTTTTTTTTTTTTTTTTTTTTTTTTTTTTTTTTTTTTTTTTqqqq
qqqqTTTTTTTTTTTTTTTTTTTTTTTTTTTTTTTTTTTTTTTTTTTTTTTTTTTTTTTTTTTTTTTTTTTTTTTTTTTTTTTTTTTTTTTTTTTTqqqq
qqqqTTTTTTTTTTTTTTTTTTTTTTTTTTTTTTTTTTTTTTTTTTTTTTTTTTTTTTTTTTTTTTTTTTTTTTTTTTTTTTTTTTTTTTTTTTTTqqqq
qqqqTTTTTTTTTTTTTTTTTTTTTTTTTTTTTTTTTTTTTTTTTTTTTTTTTTTTTTTTTTTTTTTTTTTTTTTTTTTTTTTTTTTTTTTTTTTTqqqq
qqqqTTTTTTTTTTTTTTTTTTTTTTTTTTTTTTTTTTTTTTTTTTTTTTTTTTTTTTTTTTTTTTTTTTTTTTTTTTTTTTTTTTTTTTTTTTTTqqqq
qqqqTTTTTTTTTTTTTTTTTTTTTTTTTTTTTTTTTTTTTTTTTTTTTTTTTTTTTTTTTTTTTTTTTTTTTTTTTTTTTTTTTTTTTTTTTTTTqqqq
qqqqTTTTTTTTTTTTTTTTTTTTTTTTTTTTTTTTTTTTTTTTTTTTTTTTTTTTTTTTTTTTTTTTTTTTTTTTTTTTTTTTTTTTTTTTTTTTqqqq
qqqqTTTTTTTTTTTTTTTTTTTTTTTTTTTTTTTTTTTTTTTTTTTTTTTTTTTTTTTTTTTTTTTTTTTTTTTTTTTTTTTTTTTTTTTTTTTTqqqq
qqqqTTTTTTTTTTTTTTTTTTTTTTTTTTTTTTTTTTTTTTTTTTTTTTTTTTTTTTTTTTTTTTTTTTTTTTTTTTTTTTTTTTTTTTTTTTTTqqqq
qqqqTTTTTTTTTTTTTTTTTTTTTTTTTTTTTTTTTTTTTTTTTTTTTTTTTTTTTTTTTTTTTTTTTTTTTTTTTTTTTTTTTTTTTTTTTTTTqqqq
qqqqTTTTTTTTTTTTTTTTTTTTTTTTTTTTTTTTTTTTTTTTTTTTTTTTTTTTTTTTTTTTTTTTTTTTTTTTTTTTTTTTTTTTTTTTTTTTqqqq
qqqqTTTTTTTTTTTTTTTTTTTTTTTTTTTTTTTTTTTTTTTTTTTTTTTTTTTTTTTTTTTTTTTTTTTTTTTTTTTTTTTTTTTTTTTTTTTTqqqq
qqqqTTTTTTTTTTTTTTTTTTTTTTTTTTTTTTTTTTTTTTTTTTTTTTTTTTTTTTTTTTTTTTTTTTTTTTTTTTTTTTTTTTTTTTTTTTTTqqqq
qqqqTTTTTTTTTTTTTTTTTTTTTTTTTTTTTTTTTTTTTTTTTTTTTTTTTTTTTTTTTTTTTTTTTTTTTTTTTTTTTTTTTTTTTTTTTTTTqqqq
qqqqTTTTTTTTTTTTTTTTTTTTTTTTTTTTTTTTTTTTTTTTTTTTTTTTTTTTTTTTTTTTTTTTTTTTTTTTTTTTTTTTTTTTTTTTTTTTqqqq
qqqqTTTTTTTTTTTTTTTTTTTTTTTTTTTTTTTTTTTTTTTTTTTTTTTTTTTTTTTTTTTTTTTTTTTTTTTTTTTTTTTTTTTTTTTTTTTTqqqq
qqqqTTTTTTTTTTTTTTTTTTTTTTTTTTTTTTTTTTTTTTTTTTTTTTTTTTTTTTTTTTTTTTTTTTTTTTTTTTTTTTTTTTTTTTTTTTTTqqqq
qqqqTTTTTTTTTTTTTTTTTTTTTTTTTTTTTTTTTTTTTTTTTTTTTTTTTTTTTTTTTTTTTTTTTTTTTTTTTTTTTTTTTTTTTTTTTTTTqqqq
qqqqTTTTTTTTTTTTTTTTTTTTTTTTTTTTTTTTTTTTTTTTTTTTTTTTTTTTTTTTTTTTTTTTTTTTTTTTTTTTTTTTTTTTTTTTTTTTqqqq
qqqqTTTTTTTTTTTTTTTTTTTTTTTTTTTTTTTTTTTTTTTTTTTTTTTTTTTTTTTTTTTTTTTTTTTTTTTTTTTTTTTTTTTTTTTTTTTTqqqq
qqqqTTTTTTTTTTTTTTTTTTTTTTTTTTTTTTTTTTTTTTTTTTTTTTTTTTTTTTTTTTTTTTTTTTTTTTTTTTTTTTTTTTTTTTTTTTTTqqqq
qqqqTTTTTTTTTTTTTTTTTTTTTTTTTTTTTTTTTTTTTTTTTTTTTTTTTTTTTTTTTTTTTTTTTTTTTTTTTTTTTTTTTTTTTTTTTTTTqqqq
qqqqTTTTTTTTTTTTTTTTTTTTTTTTTTTTTTTTTTTTTTTTTTTTTTTTTTTTTTTTTTTTTTTTTTTTTTTTTTTTTTTTTTTTTTTTTTTTqqqq
qqqqTTTTTTTTTTTTTTTTTTTTTTTTTTTTTTTTTTTTTTTTTTTTTTTTTTTTTTTTTTTTTTTTTTTTTTTTTTTTTTTTTTTTTTTTTTTTqqqq
qqqqTTTTTTTTTTTTTTTTTTTTTTTTTTTTTTTTTTTTTTTTTTTTTTTTTTTTTTTTTTTTTTTTTTTTTTTTTTTTTTTTTTTTTTTTTTTTqqqq
qqqqTTTTTTTTTTTTTTTTTTTTTTTTTTTTTTTTTTTTTTTTTTTTTTTTTTTTTTTTTTTTTTTTTTTTTTTTTTTTTTTTTTTTTTTTTTTTqqqq
qqqqTTTTTTTTTTTTTTTTTTTTTTTTTTTTTTTTTTTTTTTTTTTTTTTTTTTTTTTTTTTTTTTTTTTTTTTTTTTTTTTTTTTTTTTTTTTTqqqq
qqqqTTTTTTTTTTTTTTTTTTTTTTTTTTTTTTTTTTTTTTTTTTTTTTTTTTTTTTTTTTTTTTTTTTTTTTTTTTTTTTTTTTTTTTTTTTTTqqqq
qqqqTTTTTTTTTTTTTTTTTTTTTTTTTTTTTTTTTTTTTTTTTTTTTTTTTTTTTTTTTTTTTTTTTTTTTTTTTTTTTTTTTTTTTTTTTTTTqqqq
qqqqTTTTTTTTTTTTTTTTTTTTTTTTTTTTTTTTTTTTTTTTTTTTTTTTTTTTTTTTTTTTTTTTTTTTTTTTTTTTTTTTTTTTTTTTTTTTqqqq
qqqqTTTTTTTTTTTTTTTTTTTTTTTTTTTTTTTTTTTTTEEUUEUUEETTTTTTTTTTTTTTTTTTTTTTTTTTTTTTTTTTTTTTTTTTTTTTqqqq
qqqqTTTTTTTTTTTTTTTTTTTTTTTTTTTTTTTTTTTTTEggewYgbETTTTTTTTTTTTTTTTTTTTTTTTTTTTTTTTTTTTTTTTTTTTTTqqqq
qqqqTTTTTTTTTTTTTTTTTTTTTTTTTTTTTTTTTTTTTUggFmrggETTTTTTTTTTTTTTTTTTTTTTTTTTTTTTTTTTTTTTTTTTTTTTqqqq
qqqqTTTTTTTTTTTTTTTTTTTTTTTTTTTTTTTTTTTTTUggakfgVETTTTTTTTTTTTTTTTTTTTTTTTTTTTTTTTTTTTTTTTTTTTTTqqqq
qqqqTTTTTTTTTTTTTTTTTTTTTTTTTTTTTTTTTTTTTDggggggjETTTTTTTTTTTTTTTTTTTTTTTTTTTTTTTTTTTTTTTTTTTTTTqqqq
qqqqTTTTTTTTTTTTTTTTTTTTTTTTTTTTTTTTTTTTTUjgggggBETTTTTTTTTTTTTTTTTTTTTTTTTTTTTTTTTTTTTTTTTTTTTTqqqq
qqqqTTTTTTTTTTTTTTTTTTTTTTTTTTTTTTTTTTTTTUjglzzzxETTTTTTTTTTTTTTTTTTTTTTTTTTTTTTTTTTTTTTTTTTTTTTqqqq
qqqqTTTTTTTTTTTTTTTTTTTTTTTTTTTTTTTTTTTTTEjjSoKOtETTTTTTTTTTTTTTTTTTTTTTTTTTTTTTTTTTTTTTTTTTTTTTqqqq
qqqqTTTTTTTTTTTTTTTTTTTTTTTTTTTTTTTTTTTTTEEEEdEEEETTTTTTTTTTTTTTTTTTTTTTTTTTTTTTTTTTTTTTTTTTTTTTqqqq
qqqqTTTTTTTTTTTTTTTTTTTTTTTTTTTTTTTTTTTTTTJupiLyMucTTTTTTTTTTTTTTTTTTTTTTTTTTTTTTTTTTTTTTTTTTTTTqqqq
qqqqTTTTTTTTTTTTTTTTTTTTTTTTTTTTTTTTTTTTTTnhWhshWhPTTTTTTTTTTTTTTTTTTTTTTTTTTTTTTTTTTTTTTTTTTTTTqqqq
qqqqTTTTTTTTTTTTTTTTTTTTTTTTTTTTTTTTTTTTTTnhWhshWhPTTTTTTTTTTTTTTTTTTTTTTTTTTTTTTTTTTTTTTTTTTTTTqqqq
qqqqTTTTTTTTTTTTTTTTTTTTTTTTTTTTTTTTTTTTTTnhWhNhWhPTTTTTTTTTTTTTTTTTTTTTTTTTTTTTTTTTTTTTTTTTTTTTqqqq
qqqqTTTTTTTTTTTTTTTTTTTTTTTTTTTTTTTTTTTTTTnhWhThWhPTTTTTTTTTTTTTTTTTTTTTTTTTTTTTTTTTTTTTTTTTTTTTqqqq
qqqqTTTTTTTTTTTTTTTTTTTTTTTTTTTTTTTTTTTTTTnhZhThZhPTTTTTTTTTTTTTTTTTTTTTTTTTTTTTTTTTTTTTTTTTTTTTqqqq
qqqqTTTTTTTTTTTTTTTTTTTTTTTTTTTTTTTTTTTTTTGIIIIIIIHTTTTTTTTTTTTTTTTTTTTTTTTTTTTTTTTTTTTTTTTTTTTTqqqq
qqqqTTTTTTTTTTTTTTTTTTTTTTTTTTTTTTTTTTTTTTTTTTTTTTTTTTTTTTTTTTTTTTTTTTTTTTTTTTTTTTTTTTTTTTTTTTTTqqqq
qqqqTTTTTTTTTTTTTTTTTTTTTTTTTTTTTTTTTTTTTTTTTTTTTTTTTTTTTTTTTTTTTTTTTTTTTTTTTTTTTTTTTTTTTTTTTTTTqqqq
qqqqTTTTTTTTTTTTTTTTTTTTTTTTTTTTTTTTTTTTTTTTTTTTTTTTTTTTTTTTTTTTTTTTTTTTTTTTTTTTTTTTTTTTTTTTTTTTqqqq
qqqqTTTTTTTTTTTTTTTTTTTTTTTTTTTTTTTTTTTTTTTTTTTTTTTTTTTTTTTTTTTTTTTTTTTTTTTTTTTTTTTTTTTTTTTTTTTTqqqq
qqqqTTTTTTTTTTTTTTTTTTTTTTTTTTTTTTTTTTTTTTTTTTTTTTTTTTTTTTTTTTTTTTTTTTTTTTTTTTTTTTTTTTTTTTTTTTTTqqqq
qqqqTTTTTTTTTTTTTTTTTTTTTTTTTTTTTTTTTTTTTTTTTTTTTTTTTTTTTTTTTTTTTTTTTTTTTTTTTTTTTTTTTTTTTTTTTTTTqqqq
qqqqTTTTTTTTTTTTTTTTTTTTTTTTTTTTTTTTTTTTTTTTTTTTTTTTTTTTTTTTTTTTTTTTTTTTTTTTTTTTTTTTTTTTTTTTTTTTqqqq
qqqqTTTTTTTTTTTTTTTTTTTTTTTTTTTTTTTTTTTTTTTTTTTTTTTTTTTTTTTTTTTTTTTTTTTTTTTTTTTTTTTTTTTTTTTTTTTTqqqq
qqqqTTTTTTTTTTTTTTTTTTTTTTTTTTTTTTTTTTTTTTTTTTTTTTTTTTTTTTTTTTTTTTTTTTTTTTTTTTTTTTTTTTTTTTTTTTTTqqqq
qqqqTTTTTTTTTTTTTTTTTTTTTTTTTTTTTTTTTTTTTTTTTTTTTTTTTTTTTTTTTTTTTTTTTTTTTTTTTTTTTTTTTTTTTTTTTTTTqqqq
qqqqTTTTTTTTTTTTTTTTTTTTTTTTTTTTTTTTTTTTTTTTTTTTTTTTTTTTTTTTTTTTTTTTTTTTTTTTTTTTTTTTTTTTTTTTTTTTqqqq
qqqqTTTTTTTTTTTTTTTTTTTTTTTTTTTTTTTTTTTTTTTTTTTTTTTTTTTTTTTTTTTTTTTTTTTTTTTTTTTTTTTTTTTTTTTTTTTTqqqq
qqqqTTTTTTTTTTTTTTTTTTTTTTTTTTTTTTTTTTTTTTTTTTTTTTTTTTTTTTTTTTTTTTTTTTTTTTTTTTTTTTTTTTTTTTTTTTTTqqqq
qqqqTTTTTTTTTTTTTTTTTTTTTTTTTTTTTTTTTTTTTTTTTTTTTTTTTTTTTTTTTTTTTTTTTTTTTTTTTTTTTTTTTTTTTTTTTTTTqqqq
qqqqTTTTTTTTTTTTTTTTTTTTTTTTTTTTTTTTTTTTTTTTTTTTTTTTTTTTTTTTTTTTTTTTTTTTTTTTTTTTTTTTTTTTTTTTTTTTqqqq
qqqqTTTTTTTTTTTTTTTTTTTTTTTTTTTTTTTTTTTTTTTTTTTTTTTTTTTTTTTTTTTTTTTTTTTTTTTTTTTTTTTTTTTTTTTTTTTTqqqq
qqqqTTTTTTTTTTTTTTTTTTTTTTTTTTTTTTTTTTTTTTTTTTTTTTTTTTTTTTTTTTTTTTTTTTTTTTTTTTTTTTTTTTTTTTTTTTTTqqqq
qqqqTTTTTTTTTTTTTTTTTTTTTTTTTTTTTTTTTTTTTTTTTTTTTTTTTTTTTTTTTTTTTTTTTTTTTTTTTTTTTTTTTTTTTTTTTTTTqqqq
qqqqTTTTTTTTTTTTTTTTTTTTTTTTTTTTTTTTTTTTTTTTTTTTTTTTTTTTTTTTTTTTTTTTTTTTTTTTTTTTTTTTTTTTTTTTTTTTqqqq
qqqqTTTTTTTTTTTTTTTTTTTTTTTTTTTTTTTTTTTTTTTTTTTTTTTTTTTTTTTTTTTTTTTTTTTTTTTTTTTTTTTTTTTTTTTTTTTTqqqq
qqqqTTTTTTTTTTTTTTTTTTTTTTTTTTTTTTTTTTTTTTTTTTTTTTTTTTTTTTTTTTTTTTTTTTTTTTTTTTTTTTTTTTTTTTTTTTTTqqqq
qqqqTTTTTTTTTTTTTTTTTTTTTTTTTTTTTTTTTTTTTTTTTTTTTTTTTTTTTTTTTTTTTTTTTTTTTTTTTTTTTTTTTTTTTTTTTTTTqqqq
qqqqTTTTTTTTTTTTTTTTTTTTTTTTTTTTTTTTTTTTTTTTTTTTTTTTTTTTTTTTTTTTTTTTTTTTTTTTTTTTTTTTTTTTTTTTTTTTqqqq
qqqqTTTTTTTTTTTTTTTTTTTTTTTTTTTTTTTTTTTTTTTTTTTTTTTTTTTTTTTTTTTTTTTTTTTTTTTTTTTTTTTTTTTTTTTTTTTTqqqq
qqqqTTTTTTTTTTTTTTTTTTTTTTTTTTTTTTTTTTTTTTTTTTTTTTTTTTTTTTTTTTTTTTTTTTTTTTTTTTTTTTTTTTTTTTTTTTTTqqqq
qqqqTTTTTTTTTTTTTTTTTTTTTTTTTTTTTTTTTTTTTTTTTTTTTTTTTTTTTTTTTTTTTTTTTTTTTTTTTTTTTTTTTTTTTTTTTTTTqqqq
qqqqTTTTTTTTTTTTTTTTTTTTTTTTTTTTTTTTTTTTTTTTTTTTTTTTTTTTTTTTTTTTTTTTTTTTTTTTTTTTTTTTTTTTTTTTTTTTqqqq
qqqqTTTTTTTTTTTTTTTTTTTTTTTTTTTTTTTTTTTTTTTTTTTTTTTTTTTTTTTTTTTTTTTTTTTTTTTTTTTTTTTTTTTTTTTTTTTTqqqq
qqqqTTTTTTTTTTTTTTTTTTTTTTTTTTTTTTTTTTTTTTTTTTTTTTTTTTTTTTTTTTTTTTTTTTTTTTTTTTTTTTTTTTTTTTTTTTTTqqqq
qqqqTTTTTTTTTTTTTTTTTTTTTTTTTTTTTTTTTTTTTTTTTTTTTTTTTTTTTTTTTTTTTTTTTTTTTTTTTTTTTTTTTTTTTTTTTTTTqqqq
qqqqTTTTTTTTTTTTTTTTTTTTTTTTTTTTTTTTTTTTTTTTTTTTTTTTTTTTTTTTTTTTTTTTTTTTTTTTTTTTTTTTTTTTTTTTTTTTqqqq
qqqqTTTTTTTTTTTTTTTTTTTTTTTTTTTTTTTTTTTTTTTTTTTTTTTTTTTTTTTTTTTTTTTTTTTTTTTTTTTTTTTTTTTTTTTTTTTTqqqq
qqqqTTTTTTTTTTTTTTTTTTTTTTTTTTTTTTTTTTTTTTTTTTTTTTTTTTTTTTTTTTTTTTTTTTTTTTTTTTTTTTTTTTTTTTTTTTTTqqqq
qqqqTTTTTTTTTTTTTTTTTTTTTTTTTTTTTTTTTTTTTTTTTTTTTTTTTTTTTTTTTTTTTTTTTTTTTTTTTTTTTTTTTTTTTTTTTTTTqqqq
qqqqTTTTTTTTTTTTTTTTTTTTTTTTTTTTTTTTTTTTTTTTTTTTTTTTTTTTTTTTTTTTTTTTTTTTTTTTTTTTTTTTTTTTTTTTTTTTqqqq
qqqqTTTTTTTTTTTTTTTTTTTTTTTTTTTTTTTTTTTTTTTTTTTTTTTTTTTTTTTTTTTTTTTTTTTTTTTTTTTTTTTTTTTTTTTTTTTTqqqq
qqqqTTTTTTTTTTTTTTTTTTTTTTTTTTTTTTTTTTTTTTTTTTTTTTTTTTTTTTTTTTTTTTTTTTTTTTTTTTTTTTTTTTTTTTTTTTTTqqqq
qqqqTTTTTTTTTTTTTTTTTTTTTTTTTTTTTTTTTTTTTTTTTTTTTTTTTTTTTTTTTTTTTTTTTTTTTTTTTTTTTTTTTTTTTTTTTTTTqqqq
qqqqTTTTTTTTTTTTTTTTTTTTTTTTTTTTTTTTTTTTTTTTTTTTTTTTTTTTTTTTTTTTTTTTTTTTTTTTTTTTTTTTTTTTTTTTTTTTqqqq
qqqqTTTTTTTTTTTTTTTTTTTTTTTTTTTTTTTTTTTTTTTTTTTTTTTTTTTTTTTTTTTTTTTTTTTTTTTTTTTTTTTTTTTTTTTTTTTTqqqq
qqqqTTTTTTTTTTTTTTTTTTTTTTTTTTTTTTTTTTTTTTTTTTTTTTTTTTTTTTTTTTTTTTTTTTTTTTTTTTTTTTTTTTTTTTTTTTTTqqqq
qqqqTTTTTTTTTTTTTTTTTTTTTTTTTTTTTTTTTTTTTTTTTTTTTTTTTTTTTTTTTTTTTTTTTTTTTTTTTTTTTTTTTTTTTTTTTTTTqqqq
qqqqTTTTTTTTTTTTTTTTTTTTTTTTTTTTTTTTTTTTTTTTTTTTTTTTTTTTTTTTTTTTTTTTTTTTTTTTTTTTTTTTTTTTTTTTTTTTqqqq
qqqqTTTTTTTTTTTTTTTTTTTTTTTTTTTTTTTTTTTTTTTTTTTTTTTTTTTTTTTTTTTTTTTTTTTTTTTTTTTTTTTTTTTTTTTTTTTTqqqq
qqqqTTTTTTTTTTTTTTTTTTTTTTTTTTTTTTTTTTTTTTTTTTTTTTTTTTTTTTTTTTTTTTTTTTTTTTTTTTTTTTTTTTTTTTTTTTTTqqqq
qqqqqqqqqqqqqqqqqqqqqqqqqqqqqqqqqqqqqqqqqqqqqqqqqqqqqqqqqqqqqqqqqqqqqqqqqqqqqqqqqqqqqqqqqqqqqqqqqqqq
qqqqqqqqqqqqqqqqqqqqqqqqqqqqqqqqqqqqqqqqqqqqqqqqqqqqqqqqqqqqqqqqqqqqqqqqqqqqqqqqqqqqqqqqqqqqqqqqqqqq
qqqqqqqqqqqqqqqqqqqqqqqqqqqqqqqqqqqqqqqqqqqqqqqqqqqqqqqqqqqqqqqqqqqqqqqqqqqqqqqqqqqqqqqqqqqqqqqqqqqq
qqqqqqqqqqqqqqqqqqqqqqqqqqqqqqqqqqqqqqqqqqqqqqqqqqqqqqqqqqqqqqqqqqqqqqqqqqqqqqqqqqqqqqqqqqqqqqqqqqqq
"}
